20 20
WWWWWWWWWWWWWWWWWWWW
WEEEEEEEEEEEEEEEEEEW
WEEEEEEEEEEEEEEEEEEW
WEEEEEEEEEEEEEEEEEEW
WEEEEEEEEEAEEEEEEEEW
WEEEEEEEEEEEEEEEEEEW
WEEEEEEEEEEEBBBEEEEW
WEEEEEEEEHBBBEBEEEEW
WEEEEEEEEEEBBBBEEEEW
WEEEEEEEEEEEEEEEEEEW
WEEEEEEEEEEEEEEEEEEW
WEEEEEEEEEEEEEEEEEEW
WEEEEEEEEEEEEEEEEEEW
WEEEEEEEEEEEEEEEEEEW
WEEEEEEEEEEEEEEEEEEW
WEEEEEEEEEEEEEEEEEEW
WEEEEEEEEEEEEEEEEEEW
WEEEEEEEEEEEEEEEEEEW
WEEEEEEEEEEEEEEEEEEW
WWWWWWWWWWWWWWWWWWWW