20 20
WWWWWWWWWWWWWWWWWWWW
WEEEEEEEEEEEEEEEEEEW
WEEEEEEEEEEEEEEEEEEW
WEEEEEEEEEEEEEEEEEEW
WEEEEEEEEEEEEEEEEEEW
WEEEEEEEEEEAEEEEEEEW
WEEEEEEEEEEEEEEEEEEW
WEEEEEEEEEEEEEEEEEEW
WEEEEEEEEEEEEEEEEEEW
WEEEEEEEEEEEEEEEEEEW
WEEEEEEEEEEEEEEEEEEW
WEEEEEEEEEEEEEEEEEEW
WEEEEEEEEEEEEEEEEEEW
WEEEEEEEEEEEEEEEEEEW
WEEEEEEEEEEEEEEEEEEW
WEEEEEEEEEEEEEEEEEEW
WEEEEEEEEEEEEEEEEEEW
WEEEEEEEEEEEEEEEEEEW
WEEEEEEEEEEEEEEEEEEW
WWWWWWWWWWWWWWWWWWWW