20 20
WWWWWWWWWWWWWWWWWWWW
WEEEEEEEEEEEEEEEEEEW
WEEEEEEEEEEEEEEEEEEW
WEEEEEEEEEAEEEEEEEEW
WEEEEEEEEEEEEEEEEEEW
WEEEEEEEEEEEEEEEEEEW
WEEEEEEEEEHEEEEEEEEW
WEEEEEEEEEBEEEEEEEEW
WEEEEEEEEEBEEEEEEEEW
WEEEEEEEEEBEEEEEEEEW
WEEEEEEEEEEEEEEEEEEW
WEEEEEEEEEEEEEEEEEEW
WEEEEEEEEEEEEEEEEEEW
WEEEEEEEEEEEEEEEEEEW
WEEEEEEEEEEEEEEEEEEW
WEEEEEEEEEEEEEEEEEEW
WEEEEEEEEEEEEEEEEEEW
WEEEEEEEEEEEEEEEEEEW
WEEEEEEEEEEEEEEEEEEW
WWWWWWWWWWWWWWWWWWWW